Bianca	Campos
EmreT	Acikgoz
Emre	Erkilinc
Giada	Marconi
Javier	Carreno
Alex	Han
Juan	Aguas
Charles	Yin
Marcelo	Longen
Marla	Lima
Minami	Munakata
Nagisa	Kojima
Natsumi	Kobayashi
Suelen	Tanaka
Victor	Fochezatto
Chin	Suruxruttanaskul
Yukako	Sunabe
Rei	Yoshizawa
Kenta	Kodashima
Jacob	Lee
